R 1 1
NO src/img/wood.xpm
SO src/img/stone.xpm
WE src/img/cobblestone.xpm
EA src/img/diamond.xpm

S src/img/creeper.xpm
F 255,186,100
C 0,186,255

        1111111111111111111111111
        1000000000110000000000001
        1011002001110000001000001
        1001000200000000010220001
111111111011000001110000000000001
100000000011000001110111100011111
11110111111111011100000010001
11110111111111011101010010001
11000000110101011100000010001
10001000000000001100000010001
10000002020000001101010010001
11000001110101011111011110N0111
11110111 1110101 101111010001
11111111 1111111 111111111111